{
  "rows": 6,
  "cols": 10,
  "grid": [
    [1,1,1,1,1,1,1,1,1,1],
    [1,1,1,1,1,1,1,1,1,1],
    [1,1,0,0,1,1,0,0,1,1],
    [0,0,0,0,0,0,0,0,0,0],
    [1,1,1,1,1,1,1,1,1,1],
    [1,1,1,1,1,1,1,1,1,1]
  ]
}
